R 800 800
NO textures/wall_1.xpm
SO textures/wall_2.xpm
WE textures/wall_3.xpm
EA textures/wall_4.xpm

X textures/sprite_1.xpm
S textures/sprite_2.xpm
S textures/sprite_3.xpm


F 0,140,0
C 0,0,140

11111111111
10001001001
10001001001
10111001001
100E0000X01
11111111111

11111111111
10X01001001
10001001001
10111001001
10000000W01
11111111111
