R 800 800
NO textures/wall_1.xpm
SO textures/wall_2.xpm
WE textures/wall_3.xpm
EA textures/wall_4.xpm

Y textures/sprite_1.xpm
S textures/sprite_1.xpm
S textures/sprite_1.xpm

S textures/sprite_1.xpm
F textures/sky_1.xpm
C textures/floor_1.xpm

1111111111111111
10S0000000000001
1000000000000001
1000000000000001
1111111111111111

1111111111111111
1000000000000001
10S0000000000001
1000000000000001
1111111111111111



