R 400 400
NO ./textures/north
SO ./textures/south
WE ./textures/west
EA ./textures/east

S ./textures/sprite1
F 220,100,0
C 225,30,0

11111111111
10001001001
10001001001
10111001001
100E0000001
11111111111
